dYCU	seed
sZAY	NWl
AtxO	S
JcWv	seed.*?**
xBfP	seed.P
OiBO	seed.W
IuUH	seed.F
CafV	NWl.?***
YCje	NWl.**N*.P
ISkl	NWl.**W*.P.E
nGEr	NWl.**W*.P
LEKv	NWl.**M*.P
iQvy	NWl.**Y*.P
SAqw	NWl.**Y*.W
OwBJ	NWl.**Y*.F
nDdv	NWl.N*Y*.F
CKeR	NWl.W*Y*.F.Sl
vwwN	NWl.Y*Y*.F
ZxAZ	Sl.***N.P
sRxu	Sl.***Y.P
wykb	Sl.***Y.W
clZV	Sl.***Y.F
Ptpn	NWl.**W*.P.seed'
FSPb	seed'
vESx	seed'.**W*.NWl'
nxAt	seed'.**M*
Ybcn	seed'.**Y*
oPOH	NWl'
IwTl	NWl.W*Y*.F
Ixcs	NWl.W*Y*.F.Sl'
OdfW	seed'.**Y*.Sl'
KOic	seed'.**W*
gtUp	NWl'.**W*.Sl'
mDyw	Nl'
tzUm	NWl'.**M*
hxut	NWl'.**N*
jpVu	NWl.M*Y*.F
BiAQ	seed'.**N*
lrYq	Sl
XHVC	seed'.**W*.Sl'
FrpE	seed'.*N**.P
ATNE	NWl'.****.P
riNS	NWl'.****.W
tcvx	Nl'.***W.P.NW''
gahu	NW''
HvoZ	Nl'.***M.P
TyPs	Nl'.***Y.P
yGBe	NWl'.**N*.F
irQa	seed'.*Y**.F
eUzP	seed'.*Y**.P
wDhj	seed'.*Y**.W
LYFx	NWl'.**W*.F.E''
VdON	Nl'.***W.P.E''
iggI	NWl'.**W*.F
ynhL	NW''.***W.F.E''
gdZN	Nl'.***W.P
PnSX	E''
hdXX	NW''.***M.F
MQtr	NW''.***N.F
pynj	NWl'.**M*.F
RLaK	NWl'.**Y*.F
qcep	Nl'.***N.P
ywxm	NW''.***W.F.S''
ERot	Nl'.***Y.W
Pllk	Sl''
BtsJ	NW''.***Y.F
bWUv	Nl'.***Y.F
pjcI	NW.**?*
VKSd	N
zuIk	E
EBUL	NW
vBji	NW.?***
KRgY	NW.??**
czwA	E.*?**
CMGg	N.?***
Gncc	NW.?*?*
GJyt	E.**N*.P
VMpG	NW.***N.P
jyzl	N.***N.P
BBzd	NW.**N*.P
ayYe	E.*N**.P
RmIc	S.***N.P
QPzv	NW.*?**
gpvw	NW.**W*.P.seed'
cHFC	NW.**W*.P
ASvO	E.**W*.P.seed'
xIAe	E.**W*.P
dXxd	E.**M*.P
YREN	NW.**M*.P
nRTv	NW.**Y*.P
geKt	Nl.**N*.P
XyWg	NE.W*Y*.F.Sl'
vRxv	Sl'
ZxyQ	Nl'.**M*
mRjI	NE.Y*Y*.F
wohO	Sl.***W.P.NW''
FyYz	Nl'.****.W
DFZa	Sl'.***M.P
NZBN	Sl'.***N.P
QfJk	Nl'.**N*.F
BmbV	Sl.***W.P.E''
DeGL	Nl'.**W*.F
bkDo	Sl'.***W.P
BFke	NE.**Y*.P
NvCh	NE.**M*.P
OxBs	NE.**W*.P
YgGi	NE.**W*.P.seed'
HKED	NE.**N*.P
QrQY	NE.??**
voRG	NE.?***
RPly	Nl'.**W*.F.E''
JrPP	NE.W*Y*.F
QIaM	Nl'.****.P
xCpo	Sl'.***W.P.NW''
EtaW	Sl'.***W.P.E''
Erhs	Nl'.**M*.F
ITZa	Sl'.***Y.P
OZbU	Nl'.**Y*.F
qSvC	NW''.***W.F.Sl''
zudc	Sl'.***Y.W
LMov	Nl
DwLR	NE
ucyt	Nl.?***
RtLa	NE.*?**
AwRP	Nl.**W*.P.seed'
wWox	Nl.**M*.P
qfaK	Nl.**Y*.P
jnvu	Nl.**Y*.W
ZHKY	seed'.**W*.Nl'
JQSa	NE.M*Y*.F
ULLE	Nl'.**W*.Sl'
BzMR	NE.N*Y*.F
YXHY	NE.**Y*.W
fiTI	E.**W*.P.NE'
pqof	Nl.**W*.P.NE'
DEMO	Nl.**W*.P
aPvh	seed'.**W*.NE'
LvcC	NE'
ObeM	S.***Y.W
rFUe	NE.W*Y*.F.S'
jRKU	E.**W*.P.S'
cwhK	Nl.**W*.P.S'
EkDJ	seed'.**W*.S'
DBmj	NE'.**W*.S'
pySW	S'
qXGb	NE'.**M*
QPAi	NE'.**N*
mEmp	S.***Y.F
QBbt	E.**Y*.P
ehDi	E.**Y*.W
apgF	Nl.**W*.P.E'
QlfV	seed'.**W*.E'
lTea	NE'.**W*.E'
spDg	E'
aMsh	E.**Y*.F
ZytW	NE'.**W*.Nl'
VSwu	NE'.**W*
QhDV	E'.**W*.Nl'
xuNF	E'.**M*
hrgW	E'.**N*
AUUw	N.***Y.W
gFjw	NE.W*Y*.F.N'
ASiS	seed'.**W*.N'
uqqW	NE'.**W*.N'
BbgG	E'.**W*.N'
GbAY	E'.**W*
czRs	Nl'.**W*.N'
nvZD	N'
Pqas	Nl'.**N*
qqny	N.N**Y.F
ZuFB	NW.***Y.W
kJUr	N.W**Y.F.NW'
Wrtd	N.W**Y.F
rrit	NE.W*Y*.F.NW'
pGZy	seed'.**W*.NW'
gMft	NE'.**W*.NW'
AsdY	E'.**W*.NW'
NicA	Nl'.**W*.NW'
uHun	N'.***W.NW'
BPzd	Nl'.**W*
Wakp	NW'
cHxp	N'.***M
HHxS	N'.***N
hjJI	NW.**NY.F
scZj	N.M**Y.F
jEUa	NcE'.**M*
aqTH	NcE'.**N*
WGWm	NcE'.**W*.Nl'
DSva	NcE'.**W*
wTEx	NcE'.**W*.N'
pVgj	NcE'.**W*.NW'
KhmY	NcE'.**W*.E'
RPDK	NW.N*WY.F
OkYh	E.*Y**.W
jCOq	NW.N*WY.F.E'
EWlK	NW.N*NW.F
JEbL	N.W**Y.F.E'
vtTU	NE.W**Y.F.E'
qFot	NE.W**Y.F
KXNZ	E.**W*.F
IgjI	NW.N*NY.F
iHzT	NE.W*Y*.F.E'
pYan	E.**W*.F.E'
UnlZ	E'.**W*.E'
wUzw	Nl'.**W*.E'
vIgT	N'.***W.E'
SJcL	NW'.***W.E'
LzDN	N'.***W
qvnp	NWc'.***M
Fcsw	NWc'.***N
onin	NW.N*MY.F
enHy	NW.N*YY.F
wydx	E.*Y**.F
ydzS	Et'
ntZK	Et''
UYxe	Et
aPaE	Et.*N**.P
yiuV	N'.***W.Et'
olRq	NW'.***W.Et'
QmWM	Et.*Y**.W
XYww	NW.N*WY.F.Et'
CDns	E.**W*.F.Et'
AzeW	seed'.**W*.Et'
MYYO	E'.**W*.Et'
yRrM	Nl'.**W*.Et'
cjCs	Et.*Y**.F
Yikw	N.W**Y.F.Et'
uHAa	NE.W*Y*.F.Et'
rzTz	NcE'.**W*.Et'
MCfU	NW.W*YY.F.Sl'
aYmX	NW.W*YY.F
rEhg	N.W**Y.F.Sl'
UjYD	NcE'.**W*.Sl'
PGAW	E'.**W*.Sl'
FYQf	N'.***W.Sl'
zgVA	NWc'.***W.Sl'
xmpa	NW.M*YY.F
pEQU	NW.Y*YY.F
Cqyo	N.Y**Y.F
QXec	NE'.NN**.P
KlBo	E'.*N**.P
hnkO	NE'.**Y*.P
YMcW	NE'.*N**.P
GBNO	S'.***N.P
UjWM	NE'.N*Y*.P
HlTv	N'.***W.P.NW''
hgWI	Nl'.**N*.W
zyNR	NW'.***W.P.NW''
GfOW	N'.***W.P
OYma	NW'.***W.P
IqAz	NW'.***M.P
ueva	NW'.***N.P
IxwB	N'.***M.P
QrMB	N'.***N.P
xKrr	E'.*Y**.W
XOCQ	Nl'.**W*.F.W''
nGmT	N'.***W.P.W''
sSJg	NW'.***W.P.W''
WRvY	Sl'.***W.P.W''
yWjV	NW''.***W.W''
uwuz	W''
gyZK	NW''.***M
datc	E'.*YN*.F
PQpK	NW''.***N
QnKI	NE'.NYN*.W
HZXR	E'.*YW*.F.NW''
Noso	E'.*YW*.F
prNN	Nl'.**W*.F.NW''
sjuI	NW''.***W.NW''
fxgZ	W''.*W**.NW''
nADj	NW''.***W
SiVE	W''.*M**
skhB	W''.*N**
YiFF	NE'.NYN*.F
dcqJ	E'.*YM*.F
fRbl	NW''.*N**
aMtW	NW''.*M**
tmMn	S'.***Y.W
CTvb	NE'.WYN*.F.S''
MSYn	NE'.WYN*.F
UErb	E'.*YW*.F.S''
KyGn	E'.**W*.F
vCJV	Nl'.**W*.F.S''
YZRc	N'.***W.P.S''
MQdy	NW'.***W.P.S''
rxAa	Sl'.***W.P.S''
XnEq	NW''.***W.S''
XPEd	W''.*W**.S''
PFXH	NW''.*W**.S''
mumZ	W''.*W**
qUcp	NcW''.*M**
IBTU	NcW''.*N**
Oxes	NE'.MYN*.F
CyAG	S'.***Y.F
JVWx	NE'.YYN*.F
eGBR	S''
wnkW	NE'.YYW*.F.Et''
jjXZ	NE'.YYW*.F
VcnN	E'.*YW*.F.Et''
fHAs	Nl'.**W*.F.Et''
ROPc	N'.***W.P.Et''
jyyZ	NW'.***W.P.Et''
MaGC	Sl'.***W.P.Et''
yyxK	NW''.***W.Et''
guOe	W''.*W**.Et''
IzLh	NcW''.*W**.Et''
MaFI	NcWc''.*M**.Et''
WfpZ	Wc''.*M**
jjze	NWc''.***M
Pfuu	NWc''.***N
fXrE	NE'.YYM*.F
FRiV	NE'.YYY*.F
LlJO	E'.*YY*.F
IkZp	Nl'.N*Y*.F
xgZU	N'.***Y.P
AZoO	NW'.***W.P.N''
cvvd	Sl'.***W.P.N''
UajE	NWc''.***W.N''
YANw	N''.***N
WfFd	NW'.***Y.P
ysDg	N'.***Y.F
MyJX	N'.***Y.W
wmKS	N''.***M
XQJr	N.***Y.P
OGge	NW'.***Y.W
wBoQ	NWc''.***W.NW''
REDm	N''.***W.NW''
ZdsB	NW'.**NY.F
PJwh	NWc''.***W
YuZk	Et'.*Y**.W
PJim	NW'.**WY.F.Et''
vceF	NWc''.***W.Et''
ZkcZ	N''.***W.Et''
ngCa	N''.***W
Nmac	NW'.**MY.F
Ytma	Et'.*Y**.F
ETMq	NW'.**YY.F
uPcf	NW'.**WY.F
jhEu	W
SJfn	NWc''.***W.Sl''
OzVt	N''.***W.Sl''
MmYe	NW.**r*
eGqm	NE.r***
Lvfc	N.r***
BTOU	NW.r*r*
beNg	NW.r***
ajqY	W.**?*
KAGc	NW.****.P
qgRu	W.*N**.P
jGRJ	NE.**W*.P.NE'
xtLU	NE.**W*.P.S'
Wxms	NE.**W*.P.E'
QPQs	E.**W*.P.E'
GIGk	NcE'.**W*.NE'
hqhH	E'.**W*.NE'
FEhd	E.**W*.P.N'
occv	NE.**W*.P.N'
aRLV	Nl.**W*.P.N'
bkqD	E.**W*.P.NW'
zAOx	NE.**W*.P.NW'
FDCM	Nl.**W*.P.NW'
lrJh	E.**W*.P.Et'
qggm	NE.**W*.P.Et'
jYSK	Nl.**W*.P.Et'
AhnJ	NE'.**W*.Et'
tCgw	NW.W*YY.F.S'
rBnw	N.W**Y.F.S'
srXd	NcE'.**W*.S'
Fqbv	E'.**W*.S'
eReb	N'.***W.S'
mIRU	NWc'.***W.S'
UcSt	S'.***N
TbGp	NcWc'.***M
fDMx	NW'.***N
mbQX	Nc'.***M
JVje	NW.W*YY.F.N'
iDwa	N.W**Y.F.N'
NNTa	N'.***W.N'
IxWk	NWc'.***W.N'
imNU	NW.W*YY.F.NW'
XXOm	NWc'.***W.NW'
VkeE	NWc'.***W
nDhY	W.*Y**.W
GqCS	NW.N*WY.F.W'
QLqL	N.W**Y.F.W'
uTIb	NW.W*YY.F.W'
UcvA	NE.W*Y*.F.W'
PFDk	seed'.**W*.W'
jciT	E'.**W*.W'
forc	NcE'.**W*.W'
ZjXh	Nl'.**W*.W'
aZHp	N'.***W.W'
ZoYC	NWc'.***W.W'
sjUD	NW'.***W.W'
SUts	W'.*N**
YASD	NW'.***M
XfWS	W'.*M**
FRee	W.*YN*.F
OyVB	NW.*Y**.W
xJia	W.*YW*.F.NW'
IBPD	NW.*N**.P
THmw	W.*YW*.F
Ofwa	NW.N*WY.F.NW'
lmqo	NW'.***W.NW'
vmcm	W'.*W**.NW'
WlzW	NW'.***W
sdoO	NW'.*N**
EMQb	NW'.*M**
VSbX	NW.NYN*.F
Gnof	W.*YM*.F
XLJa	NW.NYW*.F.Et'
ZBkD	NW.NYW*.F
pYXl	W.*YW*.F.Et'
pIDn	NW.W*YY.F.Et'
rpXA	NWc'.***W.Et'
vBJY	W'.*W**
hKSN	W'.*W**.Et'
bEyP	NW'.*W**.Et'
ixMO	NWc'.*M**
hAlA	NWc'.*N**
sROA	NW.NYM*.F
bAMH	NW.NYY*.F
SBmD	NW.WYY*.F.S'
wKkm	NW.WYY*.F
MtCp	W.*YW*.F.S'
mPVm	NW.N*WY.F.S'
swjm	Nl'.**W*.S'
XDrm	NW'.***W.S'
azVs	W'.*W**.S'
gBQf	NWc'.*W**.S'
qmvL	NcWc'.*M**
vrhm	Wc'.*M**
pZon	NW.MYY*.F
mpFu	NW.YYY*.F
nfkw	W.*YY*.F
LBzh	NE'.YYW*.F.W''
NVLx	E'.*YW*.F.W''
hzvC	W''.*W**.W''
hsUh	NcW''.*W**.W''
taxo	NE'.YYW*.F.NW''
oNOi	NcW''.*W**.NW''
Wfil	NcW''.*W**
NsDu	NE'.WYN*.F.N''
Nwuj	E'.*YW*.F.N''
WEQZ	NE'.YYW*.F.N''
wDZx	Nl'.**W*.F.N''
cNtw	N'.***W.P.N''
BPwE	NW''.***W.N''
zBzR	W''.*W**.N''
kpSW	NcW''.*W**.N''
xpoG	NW''.*W**.N''
dfVo	N'.N**Y.F
vgVW	N'.W**Y.F.NW''
NmDC	N'.W**Y.F
eKiI	NE'.WYN*.F.NW''
ydiP	NW''.*W**.NW''
eipc	NW''.*W**
SgSS	N'.M**Y.F
pYxU	NW'.N*NY.F
mexE	NW'.N*WY.F.Et''
hlOx	N'.W**Y.F.Et''
FQJE	NW'.N*WY.F
tLVI	NE'.WYN*.F.Et''
uyPs	NW''.*W**.Et''
KUHy	NW'.N*MY.F
oelF	NW'.N*YY.F
btnF	NW'.W*YY.F.S''
logD	NW'.W*YY.F
TqHP	N'.W**Y.F.S''
EjHs	NE'.YYW*.F.S''
SbhL	NcW''.*W**.S''
leQI	N''.***W.S''
mGjD	NWc''.***W.S''
EzPB	NcWc''.***M
WoKa	Nc''.***M
fqJR	NW'.M*YY.F
sQXP	NW'.Y*YY.F
dCtL	N'.Y**Y.F
hNWC	NcWc''.*M**
GbvS	N''.***W.N''
SRFb	W'.*Y**.W
FxvC	NW'.N*WY.F.W''
Tgrz	NWc''.***W.W''
vZAa	N''.***W.W''
wijX	W'.*YN*.F
Eibn	W'.*YW*.F.NW''
ltRw	NW'.*Y**.W
jgNB	W'.*YW*.F
dpzI	NW'.N*WY.F.NW''
SpYv	W'.*YM*.F
cHvO	NW'.NYN*.F
gNIM	NW'.WYN*.F.S''
OsgB	NW'.NYW*.F
VMpR	W'.*YW*.F.S''
IlpQ	NW'.N*WY.F.S''
bMir	NW'.MYN*.F
jovJ	NW'.YYN*.F
aCus	NW'.WYN*.F
LrqC	NW'.YYW*.F.Et''
RaRE	W'.*YW*.F.Et''
pham	NW'.YYW*.F
xToP	NW'.YYM*.F
nECx	NW'.YYY*.F
aaIF	W'.*YY*.F
gDBg	W.**r*
rqzd	E.**W*.P.W'
lJGy	NE.**W*.P.W'
EUZA	Nl.**W*.P.W'
cBDA	NE'.**W*.W'
OfKy	NW.NYW*.F.W'
CddB	W.*YW*.F.W'
EoGI	W'.*W**.W'
kckQ	NW'.*W**.W'
brCz	NW.NYW*.F.NW'
iokf	NW'.*W**.NW'
fzif	NW'.*W**
hGVf	NW.NYW*.F.S'
tpJS	NW'.*W**.S'
oGtb	NW.WYY*.F.N'
eibz	W.*YW*.F.N'
Jskp	NW.NYW*.F.N'
TvAN	NW.N*WY.F.N'
qRzR	NW'.***W.N'
WWTv	W'.*W**.N'
bAYD	NW'.*W**.N'
lXmz	NWc'.*W**.N'
EOcN	NW.WYY*.F.NW'
duYJ	NWc'.*W**.NW'
THhx	NWc'.*W**
UTeK	NW.WYY*.F.Et'
RwaJ	NWc'.*W**.Et'
VCSs	NW'.W*YY.F.N''
DoDi	N'.W**Y.F.N''
YlKd	NW'.W*YY.F.NW''
sBWt	N'.W**Y.F.W''
ZECG	NW'.W*YY.F.W''
nVje	NE'.WYN*.F.W''
MnEL	NW''.*W**.W''
iyxG	NW'.W*YY.F.Et''
Mcyq	NW'.N*YY.F.N''
zZuE	NW'.YYW*.F.W''
lJtf	W'.*YW*.F.W''
hlGS	NW'.YYW*.F.NW''
LlLQ	NW'.WYN*.F.N''
mLSN	W'.*YW*.F.N''
ArTy	NW'.YYW*.F.N''
mnDm	NW'.N*WY.F.N''
iCqH	NW'.WYN*.F.NW''
XPbI	NW'.WYN*.F.Et''
oGFs	NW'.YYW*.F.S''
IvJv	NW.WYY*.F.W'
WNnk	NWc'.*W**.W'
bMHR	NW'.WYN*.F.W''
pnjW	N.***Y.F
bnUQ	NW.**YY.F
hcme	NE.r*r*
kQGA	E.**W*.P.seed
GlFt	seed'.Nl
