AiPV	seed
UjPy	NWl
DOri	S
ySad	seed.*?**
WZOW	seed.P
ReDe	seed.W
PqOc	seed.F
sAQs	NWl.?***
QxmK	NWl.**N*.P
mqrC	NWl.**W*.P.E
kLtM	NWl.**W*.P
saSq	NWl.**M*.P
ratI	NWl.**Y*.P
WEkW	NWl.**Y*.W
xYfA	NWl.**Y*.F
MmbX	NWl.N*Y*.F
OkUm	NWl.W*Y*.F.Sl
xbLG	NWl.Y*Y*.F
hBuO	Sl.***N.P
zZHd	Sl.***Y.P
OBkl	Sl.***Y.W
Mzxa	Sl.***Y.F
bTge	NWl.**W*.P.seed'
xaWb	seed'
pmJr	seed'.**W*.NWl'
EkgM	seed'.**M*
ThoA	seed'.**Y*
SevJ	NWl'
wwiv	NWl.W*Y*.F
XXzY	NWl.W*Y*.F.Sl'
UXTa	seed'.**Y*.Sl'
qzpE	seed'.**W*
ziDW	NWl'.**W*.Sl'
YqLY	Nl'
dnad	NWl'.**M*
bxUW	NWl'.**N*
fjHw	NWl.M*Y*.F
lAqW	seed'.**N*
rkPa	Sl
Vnuu	seed'.**W*.Sl'
WLdp	seed'.*N**.P
VKpr	NWl'.****.P
UAzK	NWl'.****.W
tdpt	Nl'.***W.P.NW''
JCcu	NW''
qtJW	Nl'.***M.P
npLb	Nl'.***Y.P
UeQs	NWl'.**N*.F
DjTT	seed'.*Y**.F
qlbj	seed'.*Y**.P
FgLG	seed'.*Y**.W
mQVZ	NWl'.**W*.F.E''
GAKf	Nl'.***W.P.E''
Nolx	NWl'.**W*.F
IcNL	NW''.***W.F.E''
xnBo	Nl'.***W.P
atti	E''
jdfk	NW''.***M.F
AQdO	NW''.***N.F
JmuS	NWl'.**M*.F
jZXY	NWl'.**Y*.F
GNOU	Nl'.***N.P
UcqH	NW''.***W.F.S''
ynmg	Nl'.***Y.W
ETcm	Sl''
iFmN	NW''.***Y.F
roWq	Nl'.***Y.F
IrEH	NW.**?*
KqcV	N
IvlO	E
XVpi	NW
bNCq	NW.?***
VAyZ	NW.??**
GHPz	E.*?**
zgjs	N.?***
fPYY	NW.?*?*
nVNf	E.**N*.P
Tute	NW.***N.P
YtIh	N.***N.P
yHQj	NW.**N*.P
ppWy	E.*N**.P
Dzpr	S.***N.P
dduD	NW.*?**
ySXL	NW.**W*.P.seed'
FCSp	NW.**W*.P
wUkY	E.**W*.P.seed'
zpuo	E.**W*.P
ecEk	E.**M*.P
Feeh	NW.**M*.P
Lawx	NW.**Y*.P
ultG	Nl.**N*.P
ZWSU	NE.W*Y*.F.Sl'
HMAU	Sl'
SVBH	Nl'.**M*
lhiV	NE.Y*Y*.F
wJLe	Sl.***W.P.NW''
gyQK	Nl'.****.W
lmBR	Sl'.***M.P
oVUz	Sl'.***N.P
MKJz	Nl'.**N*.F
iwRd	Sl.***W.P.E''
zhuX	Nl'.**W*.F
ldGQ	Sl'.***W.P
hJnq	NE.**Y*.P
gRFa	NE.**M*.P
bMPh	NE.**W*.P
gSRa	NE.**W*.P.seed'
QXZI	NE.**N*.P
xaSu	NE.??**
mZCh	NE.?***
sZuU	Nl'.**W*.F.E''
tODJ	NE.W*Y*.F
tQTx	Nl'.****.P
BoWw	Sl'.***W.P.NW''
rCOn	Sl'.***W.P.E''
JokJ	Nl'.**M*.F
gzsR	Sl'.***Y.P
BqqI	Nl'.**Y*.F
YtpB	NW''.***W.F.Sl''
jPcJ	Sl'.***Y.W
KZeU	Nl
Ipla	NE
FcJu	Nl.?***
tlbn	NE.*?**
Bhlc	Nl.**W*.P.seed'
rOUa	Nl.**M*.P
bygu	Nl.**Y*.P
ebAg	Nl.**Y*.W
iicf	seed'.**W*.Nl'
fhpl	NE.M*Y*.F
oTpR	Nl'.**W*.Sl'
avSP	NE.N*Y*.F
RBnR	NE.**Y*.W
Qjfb	E.**W*.P.NE'
kJit	Nl.**W*.P.NE'
KaBZ	Nl.**W*.P
Trzm	seed'.**W*.NE'
FQAb	NE'
YnQH	S.***Y.W
hCXZ	NE.W*Y*.F.S'
cpZd	E.**W*.P.S'
VpXg	Nl.**W*.P.S'
KXtp	seed'.**W*.S'
XRyy	NE'.**W*.S'
YEpF	S'
yyHB	NE'.**M*
MHvt	NE'.**N*
PPek	S.***Y.F
CAev	E.**Y*.P
hXwx	E.**Y*.W
zvJy	Nl.**W*.P.E'
syMX	seed'.**W*.E'
SzUq	NE'.**W*.E'
PLsy	E'
foyi	E.**Y*.F
GZXy	NE'.**W*.Nl'
Cyco	NE'.**W*
nXUG	E'.**W*.Nl'
nymp	E'.**M*
ukve	E'.**N*
LIdh	N.***Y.W
neNm	NE.W*Y*.F.N'
GmYg	seed'.**W*.N'
hyvI	NE'.**W*.N'
MaBy	E'.**W*.N'
GIHu	E'.**W*
qzxz	Nl'.**W*.N'
muwQ	N'
aTJH	Nl'.**N*
Wlkd	N.N**Y.F
Myme	NW.***Y.W
GYJy	N.W**Y.F.NW'
kqaY	N.W**Y.F
eOmF	NE.W*Y*.F.NW'
lFAt	seed'.**W*.NW'
wzPM	NE'.**W*.NW'
BElz	E'.**W*.NW'
YvGe	Nl'.**W*.NW'
TFta	N'.***W.NW'
hbGy	Nl'.**W*
hpcr	NW'
FBcw	N'.***M
WqZN	N'.***N
mwVM	NW.**NY.F
SXTa	N.M**Y.F
Oxwr	NcE'.**M*
doDF	NcE'.**N*
xyQN	NcE'.**W*.Nl'
ntaM	NcE'.**W*
PEWP	NcE'.**W*.N'
TSlU	NcE'.**W*.NW'
JGjv	NcE'.**W*.E'
yflZ	NW.N*WY.F
HcXQ	E.*Y**.W
bxrW	NW.N*WY.F.E'
wISo	NW.N*NW.F
XRmu	N.W**Y.F.E'
Jmnw	NE.W**Y.F.E'
kGlN	NE.W**Y.F
kHpn	E.**W*.F
mPVh	NW.N*NY.F
BgzE	NE.W*Y*.F.E'
ZtUd	E.**W*.F.E'
YUPQ	E'.**W*.E'
uuTZ	Nl'.**W*.E'
Dvaf	N'.***W.E'
Cvnu	NW'.***W.E'
gwnQ	N'.***W
rQPP	NWc'.***M
uzzv	NWc'.***N
bIdt	NW.N*MY.F
gWwd	NW.N*YY.F
GvGU	E.*Y**.F
tzJB	Et'
wwvr	Et''
uDjk	Et
yEvQ	Et.*N**.P
kBhG	N'.***W.Et'
kWHv	NW'.***W.Et'
zHNI	Et.*Y**.W
Wzcc	NW.N*WY.F.Et'
RMRV	E.**W*.F.Et'
VJet	seed'.**W*.Et'
Czvt	E'.**W*.Et'
lOPO	Nl'.**W*.Et'
VWsQ	Et.*Y**.F
irmr	N.W**Y.F.Et'
NDHF	NE.W*Y*.F.Et'
lLQQ	NcE'.**W*.Et'
UZOK	NW.W*YY.F.Sl'
uLyt	NW.W*YY.F
Ueua	N.W**Y.F.Sl'
ZmYA	NcE'.**W*.Sl'
Nbef	E'.**W*.Sl'
uVep	N'.***W.Sl'
POax	NWc'.***W.Sl'
IeIj	NW.M*YY.F
oyId	NW.Y*YY.F
IDJp	N.Y**Y.F
gvhk	NE'.NN**.P
AOAg	E'.*N**.P
ZvMW	NE'.**Y*.P
MomO	NE'.*N**.P
MHQa	S'.***N.P
UKNV	NE'.N*Y*.P
mdqX	N'.***W.P.NW''
TFrO	Nl'.**N*.W
Orjr	NW'.***W.P.NW''
ZvmX	N'.***W.P
GKqa	NW'.***W.P
fiQv	NW'.***M.P
QwJo	NW'.***N.P
Fbqx	N'.***M.P
ETef	N'.***N.P
AiOA	E'.*Y**.W
kieq	Nl'.**W*.F.W''
gwHP	N'.***W.P.W''
FFSE	NW'.***W.P.W''
zRCg	Sl'.***W.P.W''
YXqX	NW''.***W.W''
wrJm	W''
aqlo	NW''.***M
UUvJ	E'.*YN*.F
UrRy	NW''.***N
dqVt	NE'.NYN*.W
NNLv	E'.*YW*.F.NW''
pqaw	E'.*YW*.F
gpTw	Nl'.**W*.F.NW''
RfUL	NW''.***W.NW''
lijN	W''.*W**.NW''
PPjO	NW''.***W
Elhv	W''.*M**
ETLm	W''.*N**
HpoM	NE'.NYN*.F
fChl	E'.*YM*.F
TOjD	NW''.*N**
Ykks	NW''.*M**
llNk	S'.***Y.W
gPEK	NE'.WYN*.F.S''
ylbW	NE'.WYN*.F
dxWY	E'.*YW*.F.S''
vPBS	E'.**W*.F
Dlno	Nl'.**W*.F.S''
zBkU	N'.***W.P.S''
rQVX	NW'.***W.P.S''
ItIr	Sl'.***W.P.S''
mqcq	NW''.***W.S''
WsTW	W''.*W**.S''
KXWV	NW''.*W**.S''
CXSu	W''.*W**
XnlC	NcW''.*M**
zchl	NcW''.*N**
vCky	NE'.MYN*.F
vyyc	S'.***Y.F
Lmbf	NE'.YYN*.F
lTXc	S''
Edwq	NE'.YYW*.F.Et''
unpb	NE'.YYW*.F
mmeg	E'.*YW*.F.Et''
OLyZ	Nl'.**W*.F.Et''
Rjzv	N'.***W.P.Et''
fOjA	NW'.***W.P.Et''
NmXp	Sl'.***W.P.Et''
uKVW	NW''.***W.Et''
McwL	W''.*W**.Et''
pvYZ	NcW''.*W**.Et''
zOFK	NcWc''.*M**.Et''
eyFJ	Wc''.*M**
UzWW	NWc''.***M
ooVN	NWc''.***N
oSsX	NE'.YYM*.F
pWoN	NE'.YYY*.F
MbbB	E'.*YY*.F
tzfF	Nl'.N*Y*.F
Fqso	N'.***Y.P
vspJ	NW'.***W.P.N''
IUly	Sl'.***W.P.N''
wHNg	NWc''.***W.N''
LhSP	N''.***N
DqbQ	NW'.***Y.P
eXMf	N'.***Y.F
CoFa	N'.***Y.W
UYBp	N''.***M
pjdW	N.***Y.P
xMCT	NW'.***Y.W
BLZs	NWc''.***W.NW''
dDbK	N''.***W.NW''
bZZg	NW'.**NY.F
TvTb	NWc''.***W
Rjkq	Et'.*Y**.W
nKgs	NW'.**WY.F.Et''
paul	NWc''.***W.Et''
hiBo	N''.***W.Et''
OeNG	N''.***W
vrjJ	NW'.**MY.F
jayc	Et'.*Y**.F
KZcW	NW'.**YY.F
IMyo	NW'.**WY.F
gbtK	W
uNMx	NWc''.***W.Sl''
dZaA	N''.***W.Sl''
bmfv	NW.**r*
seoE	NE.r***
ekMU	N.r***
FozZ	NW.r*r*
xNsj	NW.r***
qAvJ	W.**?*
OrKf	NW.****.P
yOYq	W.*N**.P
amwc	NE.**W*.P.NE'
geXG	NE.**W*.P.S'
etnm	NE.**W*.P.E'
gGdr	E.**W*.P.E'
Tzjj	NcE'.**W*.NE'
BrJe	E'.**W*.NE'
dviH	E.**W*.P.N'
LTPA	NE.**W*.P.N'
dTgX	Nl.**W*.P.N'
qpSF	E.**W*.P.NW'
tCnW	NE.**W*.P.NW'
SUIJ	Nl.**W*.P.NW'
KLnX	E.**W*.P.Et'
Nezw	NE.**W*.P.Et'
gYeU	Nl.**W*.P.Et'
rOqM	NE'.**W*.Et'
cMNn	NW.W*YY.F.S'
SJxW	N.W**Y.F.S'
HgQe	NcE'.**W*.S'
juVk	E'.**W*.S'
sRQd	N'.***W.S'
aCmZ	NWc'.***W.S'
SLwY	S'.***N
mDXu	NcWc'.***M
HWWS	NW'.***N
lOgA	Nc'.***M
qWJV	NW.W*YY.F.N'
ROZm	N.W**Y.F.N'
XEgZ	N'.***W.N'
Kqhs	NWc'.***W.N'
Tgsj	NW.W*YY.F.NW'
rCKB	NWc'.***W.NW'
dtYX	NWc'.***W
kGIk	W.*Y**.W
NoTA	NW.N*WY.F.W'
lJbL	N.W**Y.F.W'
QcyN	NW.W*YY.F.W'
NZhF	NE.W*Y*.F.W'
XtQD	seed'.**W*.W'
LwDV	E'.**W*.W'
ZRkk	NcE'.**W*.W'
ORcZ	Nl'.**W*.W'
EwvU	N'.***W.W'
OnNG	NWc'.***W.W'
NIQl	NW'.***W.W'
qydR	W'.*N**
emkM	NW'.***M
aGfk	W'.*M**
lMcu	W.*YN*.F
Oegg	NW.*Y**.W
APxJ	W.*YW*.F.NW'
zoFG	NW.*N**.P
PrQD	W.*YW*.F
PGTG	NW.N*WY.F.NW'
svBm	NW'.***W.NW'
zfzp	W'.*W**.NW'
rLCk	NW'.***W
MqWn	NW'.*N**
ogGa	NW'.*M**
Jtzm	NW.NYN*.F
zOgq	W.*YM*.F
rSKV	NW.NYW*.F.Et'
kaHJ	NW.NYW*.F
LtgY	W.*YW*.F.Et'
ZddC	NW.W*YY.F.Et'
APsv	NWc'.***W.Et'
lEQC	W'.*W**
yxwl	W'.*W**.Et'
SuyW	NW'.*W**.Et'
wAzX	NWc'.*M**
enyc	NWc'.*N**
kBHd	NW.NYM*.F
lOmn	NW.NYY*.F
OniH	NW.WYY*.F.S'
DJpy	NW.WYY*.F
uVrb	W.*YW*.F.S'
RwHi	NW.N*WY.F.S'
Zvsj	Nl'.**W*.S'
qJrc	NW'.***W.S'
cxfr	W'.*W**.S'
nclb	NWc'.*W**.S'
VTwb	NcWc'.*M**
DEZP	Wc'.*M**
BGCf	NW.MYY*.F
TaZJ	NW.YYY*.F
fOiT	W.*YY*.F
lgrN	NE'.YYW*.F.W''
VADj	E'.*YW*.F.W''
Aoul	W''.*W**.W''
zuRE	NcW''.*W**.W''
iSPP	NE'.YYW*.F.NW''
WLKP	NcW''.*W**.NW''
sSbW	NcW''.*W**
ueCf	NE'.WYN*.F.N''
YmAw	E'.*YW*.F.N''
qwGy	NE'.YYW*.F.N''
Oppg	Nl'.**W*.F.N''
vFNp	N'.***W.P.N''
GkOY	NW''.***W.N''
oXOU	W''.*W**.N''
usRJ	NcW''.*W**.N''
dBel	NW''.*W**.N''
LzEy	N'.N**Y.F
mVph	N'.W**Y.F.NW''
tFFi	N'.W**Y.F
tQmc	NE'.WYN*.F.NW''
YMen	NW''.*W**.NW''
AzTx	NW''.*W**
UeVG	N'.M**Y.F
ToPl	NW'.N*NY.F
jSnA	NW'.N*WY.F.Et''
qQeX	N'.W**Y.F.Et''
UvQb	NW'.N*WY.F
jOcG	NE'.WYN*.F.Et''
xjKp	NW''.*W**.Et''
Bane	NW'.N*MY.F
lJGb	NW'.N*YY.F
PpGe	NW'.W*YY.F.S''
KMcl	NW'.W*YY.F
cGoI	N'.W**Y.F.S''
IbaH	NE'.YYW*.F.S''
gLbo	NcW''.*W**.S''
Dglq	N''.***W.S''
yCou	NWc''.***W.S''
mogt	NcWc''.***M
vnJL	Nc''.***M
ubFS	NW'.M*YY.F
tgou	NW'.Y*YY.F
Tufa	N'.Y**Y.F
LziV	NcWc''.*M**
fjGY	N''.***W.N''
DZNP	W'.*Y**.W
xWbG	NW'.N*WY.F.W''
cxUf	NWc''.***W.W''
jRQx	N''.***W.W''
ACfY	W'.*YN*.F
PZSx	W'.*YW*.F.NW''
PrSw	NW'.*Y**.W
ufWl	W'.*YW*.F
EpuE	NW'.N*WY.F.NW''
nZzz	W'.*YM*.F
iSwo	NW'.NYN*.F
KVCV	NW'.WYN*.F.S''
oYKq	NW'.NYW*.F
WpYK	W'.*YW*.F.S''
VQRc	NW'.N*WY.F.S''
jybu	NW'.MYN*.F
SDgd	NW'.YYN*.F
eNWd	NW'.WYN*.F
cDTC	NW'.YYW*.F.Et''
xPdw	W'.*YW*.F.Et''
iZVs	NW'.YYW*.F
hOpK	NW'.YYM*.F
BLiM	NW'.YYY*.F
GLHO	W'.*YY*.F
axsV	W.**r*
tbYf	E.**W*.P.W'
fLsG	NE.**W*.P.W'
jzJp	Nl.**W*.P.W'
rVfn	NE'.**W*.W'
QeHI	NW.NYW*.F.W'
MxqV	W.*YW*.F.W'
URmk	W'.*W**.W'
RmFr	NW'.*W**.W'
wcZP	NW.NYW*.F.NW'
TYEq	NW'.*W**.NW'
qGcD	NW'.*W**
KiAI	NW.NYW*.F.S'
woyW	NW'.*W**.S'
KlLN	NW.WYY*.F.N'
SboP	W.*YW*.F.N'
XWYJ	NW.NYW*.F.N'
WnZR	NW.N*WY.F.N'
ihMt	NW'.***W.N'
NDlG	W'.*W**.N'
CRlZ	NW'.*W**.N'
bUNi	NWc'.*W**.N'
trVy	NW.WYY*.F.NW'
hlod	NWc'.*W**.NW'
OguA	NWc'.*W**
hPoH	NW.WYY*.F.Et'
htoR	NWc'.*W**.Et'
nHmW	NW'.W*YY.F.N''
oFWJ	N'.W**Y.F.N''
yTyi	NW'.W*YY.F.NW''
kNGp	N'.W**Y.F.W''
JpiT	NW'.W*YY.F.W''
RXNP	NE'.WYN*.F.W''
ngLH	NW''.*W**.W''
TsWx	NW'.W*YY.F.Et''
oUZx	NW'.N*YY.F.N''
TVUg	NW'.YYW*.F.W''
fsmL	W'.*YW*.F.W''
FhzD	NW'.YYW*.F.NW''
eqaZ	NW'.WYN*.F.N''
DCJD	W'.*YW*.F.N''
Cppy	NW'.YYW*.F.N''
eTUe	NW'.N*WY.F.N''
eyuc	NW'.WYN*.F.NW''
khOR	NW'.WYN*.F.Et''
oWmd	NW'.YYW*.F.S''
DLAx	NW.WYY*.F.W'
nATi	NWc'.*W**.W'
FdkI	NW'.WYN*.F.W''
VGwK	N.***Y.F
MMKx	NW.**YY.F
tbpS	NE.r*r*
FgMP	E.**W*.P.seed
uxaN	S''.***M
qEVK	seed'.Nl
